..........
..........
..........
..###.....
..#.......
..###.....
..........
..........
..........
..........